{
	"numX": 13,
	"numY": 9,
	"size": [64, 64],
	"start": [32, 32],
	"tileNames": ["", "ProtoCoin", "ProtoBox", "Tile", "ProtoBat", "ProtoSkull", "Platform", "Slime"],
	"tiles": [0, 0, 0, 0, 0, 0, 0, 0, 0, 0, 0, 0, 0,
			  0, 4, 5, 0, 0, 0, 1, 0, 0, 0, 5, 4, 0,
			  0, 4, 0, 0, 0, 1, 1, 1, 0, 0, 0, 4, 0,
			  0, 0, 0, 0, 0, 0, 0, 0, 0, 0, 0, 0, 0,
			  0, 1, 0, 6, 0, 7, 7, 0, 6, 0, 1, 0, 0,
			  0, 0, 2, 0, 0, 0, 0, 0, 0, 0, 2, 0, 0,
			  1, 1, 2, 2, 0, 0, 0, 0, 0, 2, 2, 1, 0,
			  0, 0, 0, 0, 0, 0, 0, 0, 0, 0, 0, 0, 0,
			  3, 3, 3, 3, 3, 3, 3, 3, 3, 3, 3, 3, 3]
}
